22222222222222222222
2131313      1313132
2                  2
22 2 2 2    12 2 2 2
2      2    2      2
2      2    2      2
2      2    2      2
2      2    2      2
2      2    2      2
2      2    2      2
2 2 2 21    2 2 2 22
2                  2
2313131      3131312
22222222222222222222